#,#,#,#,#,#,#,#,#,#
#,ひ,　,　,　,だ,#,#,#,#
#,#,#,　,#,#,#,#,#,#
#,#,#,　,#,#,#,#,#,#
#,#,#,　,#,#,#,#,#,#
#,ぐ,　,　,さ,　,　,　,だ,#
#,#,#,　,#,#,#,　,#,#
#,#,#,#,#,#,#,　,#,#
#,#,#,#,#,#,#,　,#,#
#,つ,　,　,こ,　,　,の,#,#
#,#,#,#,#,#,#,#,#,#